









EA                        photos_2022_5_17_fst_brick-wall-red-old-_1_.xpm
WE      photos_2022_5_17_fst_brick-wall-red-old-_1_.xpm



F       153, 153, 200


NO     photos_2022_5_17_fst_brick-wall-red-old-_1_.xpm
SO      photos_2022_5_17_fst_brick-wall-red-old-_1_.xpm                   
C 0, 250, 255,

        11111111111111111111111111
        10000000011000000000000001
        1011000001110000E000000011
        1001000000000000000000001
        1111111111111000000111111
111111111111111111100000000000011      
10000000001100000111000001111111        
11110111111111011100000000001
11110111111111011101010010001
10000000110101011100000010001
10000000000000011000000100111
10000001110000011110100110001
11110111 1110101 111110100111
11111111111111111 111111111